//1,2,3,4,5,6,7,8,9,10,11,12,13,14,15,16,17,18,19,20,21,22,23,24,25,26,27,28,29,30,31,32
28,42,42,42,20,42,42,28,42,42,20,28,42,20,42,42,28,42,42,42,20,42,28,42,42,42,28,42,42,20,42,28
42,32,31,31,31,31,31,31,31,31,31,31,31,31,31,31,31,31,31,31,31,31,31,31,31,31,31,31,31,31,40,42
42,33,22,24,24,24,24,24,24,24,24,24,24,24,24,24,24,24,24,24,24,24,24,24,24,24,24,24,24,24,37,42
20,33,25,-42,0,44,1,1,0,0,0,0,0,0,0,0,0,0,0,0,0,0,0,0,0,0,0,-41,60,11,37,28
28,33,25,0,10,45,1,1,0,0,0,0,0,0,0,0,0,0,0,0,0,0,0,0,0,0,0,0,0,0,37,42
42,33,25,0,0,45,2,1,0,0,0,0,0,0,0,0,0,0,0,0,0,0,0,0,0,0,0,0,0,0,37,42
42,33,25,0,0,45,2,1,0,0,0,0,0,0,0,0,0,0,0,0,0,0,0,0,0,0,0,-44,0,0,39,31
42,33,25,0,0,45,1,1,0,0,0,0,0,0,0,0,0,0,0,0,0,0,0,0,0,0,0,0,0,0,24,9
42,33,25,0,0,46,1,1,0,44,47,48,48,48,48,48,48,48,48,48,48,49,44,0,0,0,0,0,0,0,0,9
42,33,0,-43,0,0,0,0,0,45,2,1,1,1,1,1,0,0,0,0,2,7,45,1,1,1,1,0,0,0,0,9
42,33,0,0,0,10,0,0,0,46,1,1,1,1,1,1,0,0,0,0,0,0,46,1,1,1,1,0,0,0,26,9
42,33,17,0,0,0,0,0,0,43,1,1,1,1,1,1,0,0,0,0,0,0,43,1,1,1,1,0,0,0,38,35
42,33,0,-48,0,0,0,0,0,0,0,0,0,2,2,2,2,2,2,0,0,0,8,1,1,1,1,0,0,0,37,42
42,33,0,0,0,0,0,0,0,43,1,1,1,1,1,1,0,0,0,0,0,0,43,1,1,1,1,0,0,0,37,42
42,33,25,0,0,10,0,0,0,44,1,1,1,1,1,1,0,0,0,0,0,0,44,1,1,1,1,0,0,0,37,42
42,33,25,0,0,0,0,0,0,45,2,1,1,1,1,1,0,0,0,0,0,2,45,1,1,1,1,0,0,0,37,28
42,33,25,0,0,44,1,1,0,46,47,48,48,48,48,48,48,48,48,48,48,49,46,0,0,0,0,-45,0,0,37,42
42,33,25,0,0,45,1,1,0,0,0,0,0,0,0,0,0,0,0,0,0,0,0,0,0,0,0,0,0,0,37,42
20,33,25,0,0,45,2,1,0,0,0,0,0,0,0,0,0,0,0,0,0,0,0,0,0,0,0,0,0,0,37,20
42,33,25,0,0,45,2,1,0,0,0,0,0,0,0,0,0,0,0,0,0,0,0,0,0,0,0,0,0,0,37,42
28,33,25,0,10,45,1,1,0,0,0,0,0,0,0,0,0,0,0,0,0,0,0,0,0,0,0,0,0,0,37,42
42,33,25,-47,0,46,1,1,0,0,0,0,0,0,0,0,0,0,0,0,0,0,0,0,0,0,0,-46,61,11,37,28
20,33,21,26,26,26,26,26,26,26,26,26,26,26,26,26,26,26,26,26,26,26,26,26,26,26,26,26,26,26,37,42
42,34,35,35,35,35,35,35,35,35,35,35,35,35,35,35,35,35,35,35,35,35,35,35,35,35,35,35,35,35,36,42
42,42,42,42,28,42,42,20,42,42,28,42,20,42,42,42,20,42,42,42,28,42,42,42,20,20,42,42,42,42,28,42
